1111111111111111111111111111111111
1E00000000011000101001010000000001
1010010100100000101001000000010101
1010010010101010001001000000010101
1P001100001010010100001000000000C1
100001000000000C00000C000000000001
1010010100100000101001000000010101
1001000101010000011001000000010101
10001111010010011010001000000000C1
1E0000000100010101010C000000000001
1010010100100000101001000000010101
1010010010101010001001000000010101
100000000C00C0000000000000000000C1
1100010101001000010010010000000001
1010010100100000101001000000010101
100000000C00C0000000000000000000C1
1111111111111111111111111111111111
